Was ist Monitoring (nach Bates)?	Monitoring ist aktiver Aufbau von Hintergrundwissen zu Interessengebieten und möglichen zukünftigen Fragestellungen.
Was ist die zentrale Idee des Dokumentenmodells?	Die zentrale Idee des Dokumentenmodells ist, die Kerndaten des Dokuments redundanzfrei in einer Art Reinform vorzuhalten, wie man es auch beim Design relationaler Faktendatenbanken mit Normalformen verfolgt.
Wofuer wird ein Codierungsschema benutzt?	Ein Codierungsschema wird dazu genutzt, zu einem Codierungsformat zusätzlich festzulegen, wie die Codierungseinheiten in Bytefolgen zu serialisieren sind.
Wozu benötigt man eine Zeichenkodierung?	Die Textzeichen müssen in Bits und Bytes kodiert werden. Eine ZeichenCodierung gibt dazu eine Vorschrift an.
Welche Zeichenkodierung ist am bekanntesten?	US-ASCII
Was sind die Bestandteile des Codierungsmodells?	Ein abstrakter Zeichensatz, eine Codetabelle, ein Codierungsformat, ein Codierungsschema und eine Übertragungssyntax, die über sogenannten „glatten Text“ hinausgeht.
Wann wurde SGML offiziell registriert?	SGML wurde 1986 unter ISO 8879 offiziell registriert
Welche Programmiersprache wird standardmäßig verwendet, um interaktive Elemente für Webseiten zu erstellen?	JavaScript
Was sind Hypertextknoten?	Ein HTMLText ist somit die Gesamtheit von thematisch zusammengehörigen Texteinheiten, den sogenannten Hypertextknoten.
Was ist ein Browser?	Ein Web-Browser ist eine Softwarekomponente, die HTML-Dokumente aus dem Web laden und darstellen kann und welche die Möglichkeit zur Navigation entlang der eingebetteten HTML-Links bietet
Was ist das HTML-DOM?	Das HTML-DOM ist das Objektmodell und die Schnittstelle für HTML
Welche Content-Modelle gibt es in HTML5?	Es existieren sieben quasi semantische Content-Modelle: Flow-Content, Sectioning-Content, Heading-Content, Phrasing-Content, Embedded-Content, Interactive-Content und Metadata-Content
Was ist eine relative URL?	Eine relative URL besteht nur aus durch den Solidus / getrennten Pfadsegmenten
Wie viele verschiedene Arten von Knoten gibt es in XPath?	Sieben.
Wann ist ein XML-Dokument wohlgeformt? Wenn es der XML-Grammatik genügt
Was sind Namensraumknoten in XPath?	 Namensraumknoten stehen für den im aktuellen Kontext gültigen Namensraum
Was ist ein XSLT-Prozessor?	Ein XSLT-Prozessor ist eine Anwendung, die ein XML-Dokument nach Maßgabe eines XSLT-Stylesheets transformiert.
Welche Aufgabe haben Konstruktoren in XQuery?	Konstruktoren dienen dazu, neue Knoten zu erzeugen.
Was passiert während der dynamischen Auswertungsphase einer Xquery-Abfrage?	Die dynamische Auswertungsphase ist die Phase, während der der Wert eines Ausdruckes berechnet wird.
Was sind die Bestandteile eines RDF-Tripels?	Ein RDF-Tripel besteht aus einem
Was ist Reifikation?	Reifikation beschreibt die Fähigkeit, eine Aussage als eigene Ressource zu modellieren.
Welche Aufgaben werden dem benutzenden vom Semantischen Web abgenommen?	Informationssuche, Informationssammlung, Informationsklassifikation, Informationsfilterung, Informationsmanagement, Information-Mining, Informationsentdeckung, Informationsbewertung
Welche Bedeutung hat das Schlüsselwort „rdfs: range“?	Dieses Schlüsselwort spezifiziert die Klassen, deren Elemente Objekt einer bestimmten Eigenschaft sein können.
Welche Container-Klassen gibt es in RDF?	rdf: bag, rdf: Seq und rdf: Alt.
Wie wird in OWL die Äquivalenz von zwei Klassen definiert?	axiom ::= 'EquivalentClasses(' classID classID { classID } ')'
Wie kann das Problem der semantischen Heterogenität reduziert werden?	Das Problem der semantischen Heterogenität kann reduziert werden, wenn alle Begriffe, die eine Ontologie beschreibt, möglichst eindeutig und nicht-redundant definiert werden und weltweit gültig sind.
Was sind die minimalen Bestandteile einer Ontologie? Konzepte, Instanzen und Relationen.
Was ist ein Konzept?	Ein Konzept ist eine gedankliche Vorstellung bzw. die subjektive Interpretation über ein reales Ding in der Welt.
Was ist ein Wissenskontext?	Die Spezifikation eines Wissenskontexts bedeutet, dass man sich gegenseitig darauf verständigen und einigen muss, welche Bedeutung die Entitäten haben, die den Inhalt einer Web-Informationsressource repräsentieren.
Was ist eine semi-formale Sprache?	Eine semi-formale Sprache ist eine künstlich formal definierte Sprache, die die Beschreibung der Begriffe sowohl informell in einer natürlichen Sprache als auch formal in einer für Computer interpretierbaren Wissensrepräsentationssprache unterstützt.
Was sind Beschreibungslogiken?	Beschreibungslogiken(description logics) sind eine Familie von Sprachen zur Wissensrepräsentation.
Welcher Dialekt von OWL ermöglicht die Verwendung von prädikatenlogischen Ausdrücken höheren Grades?	OWL-FULL
